border_size=1
usage=map

       Gg,       Gg,    Gs^Fp,    Gs^Fp,    Gs^Fp,    Gs^Fp,       Ce,    Gs^Fp,    Gs^Fp,    Gs^Fp,    Gs^Fp,    Gs^Fp,    Gs^Fp,    Gs^Fp,       Re,       Re,       Re,       Re,       Re,    Gs^Fp,    Gs^Fp,    Gs^Fp,    Gs^Fp,    Gs^Fp,    Gs^Fp,    Gs^Fp,       Ce,    Gs^Fp,    Gs^Fp,    Gs^Fp,    Gs^Fp,    Gs^Fp
       Gg,       Gg,    Gs^Fp,    Gs^Fp,    Gs^Fp,    Gs^Fp,       Ce,    Gs^Fp,    Gs^Fp,    Gs^Fp,    Gs^Fp,    Gs^Fp,    Gs^Fp,    Gs^Fp,       Re,       Re,       Re,       Re,       Re,    Gs^Fp,    Gs^Fp,    Gs^Fp,    Gs^Fp,    Gs^Fp,    Gs^Fp,    Gs^Fp,       Ce,    Gs^Fp,    Gs^Fp,    Gs^Fp,    Gs^Fp,    Gs^Fp
    Gs^Fp,    Gs^Fp,       Gg,       Gg,       Gg,       Ce,     2 Ke,       Ce,       Gg,       Gg,       Gg,       Gg,       Gg,       Gg,       Re,       Re,       Re,       Re,       Re,       Gg,       Gg,       Gg,       Gg,       Gg,       Gg,       Ce,     3 Ke,       Ce,       Gg,       Gg,       Gg,       Gg
       Gg,       Gg,       Gg,       Gg,       Gg,       Ce,       Ce,       Ce,       Gg,       Gg,       Dd,       Dd,       Dd,       Gg,       Re,       Re,       Re,       Re,       Re,       Gg,       Dd,       Dd,       Dd,       Gg,       Gg,       Ce,       Ce,       Ce,       Gg,       Gg,       Gg,       Gg
       Gg,       Gg,       Gg,       Gg,       Dd,       Gg,       Gg,       Gg,       Ww,   Dd^Vda,   Ww^Bw|,   Ww^Bw|,   Ww^Bw|,       Dd,       Re,       Re,       Re,       Re,       Re,       Dd,   Ww^Bw|,   Ww^Bw|,   Ww^Bw|,       Dd,       Ww,       Gg,       Gg,       Gg,       Gg,       Gg,       Gg,       Gg
       Gg,       Gg,       Ww,   Dd^Vdt,       Ww,       Ww,       Ww,       Ww,       Ww,       Ww,   Ww^Bw|,   Ww^Bw|,   Ww^Bw|,   Dd^Vda,       Dd,       Re,       Rd,       Re,       Dd,   Dd^Vda,   Ww^Bw|,   Ww^Bw|,   Ww^Bw|,   Dd^Vda,       Ww,       Ww,       Ww,       Gg,   Dd^Vdt,       Gg,       Gg,       Gg
       Ww,       Ww,       Ww,       Ww,       Ww,       Ww,       Ww,       Ww,       Ww,       Ww,   Ww^Bw|,   Ww^Bw|,   Ww^Bw|,       Ww,       Dd,       Rd,       Rd,       Rd,       Dd,       Ww,   Ww^Bw|,   Ww^Bw|,   Ww^Bw|,       Ww,       Ww,       Ww,       Ww,       Ww,       Dd,       Dd,       Dd,       Dd
       Ww,       Ww,       Ww,       Ww,       Wo,       Ww,       Ww,       Ww,       Wo,       Ww,   Ww^Bw|,   Ww^Bw|,   Ww^Bw|,       Wo,       Dd,       Rd,       Rd,       Rd,       Dd,       Wo,   Ww^Bw|,   Ww^Bw|,   Ww^Bw|,       Wo,       Wo,       Ww,       Ww,       Ww,       Ww,       Ww,       Ww,       Ww
       Ww,       Ww,       Wo,       Wo,       Wo,       Wo,       Wo,       Wo,       Wo,       Wo,   Ww^Bw|,   Ww^Bw|,   Ww^Bw|,       Wo,       Dd,       Rd,       Rd,       Rd,       Dd,       Wo,   Ww^Bw|,   Ww^Bw|,   Ww^Bw|,       Wo,       Wo,       Wo,       Wo,       Wo,       Wo,       Ww,       Ww,       Ww
       Wo,       Wo,       Wo,       Wo,       Wo,       Wo,       Wo,       Wo,       Wo,       Wo,   Ww^Bw|,   Ww^Bw|,   Ww^Bw|,       Wo,       Dd,       Rd,       Rd,       Rd,       Dd,       Wo,   Ww^Bw|,   Ww^Bw|,   Ww^Bw|,       Wo,       Wo,       Wo,       Wo,       Wo,       Wo,       Wo,       Wo,       Wo
       Wo,       Wo,       Wo,       Wo,       Wo,       Wo,       Wo,       Wo,       Wo,       Wo,   Ww^Bw|,   Ww^Bw|,   Ww^Bw|,       Wo,       Dd,       Rd,       Rd,       Rd,       Dd,       Wo,   Ww^Bw|,   Ww^Bw|,   Ww^Bw|,       Wo,       Wo,       Wo,       Wo,       Wo,       Wo,       Wo,       Wo,       Wo
       Wo,       Wo,       Wo,       Wo,       Wo,       Wo,       Wo,       Wo,       Wo,       Wo,   Ww^Bw|,   Ww^Bw|,   Ww^Bw|,       Wo,       Dd,       Rd,       Rd,       Rd,       Dd,       Wo,   Ww^Bw|,   Ww^Bw|,   Ww^Bw|,       Wo,       Wo,       Wo,       Wo,       Wo,       Wo,       Wo,       Wo,       Wo
       Wo,       Wo,       Wo,       Wo,       Wo,       Wo,       Wo,       Wo,       Wo,       Wo,   Ww^Bw|,   Ww^Bw|,   Ww^Bw|,       Wo,       Dd,       Rd,       Rd,       Rd,       Dd,       Wo,   Ww^Bw|,   Ww^Bw|,   Ww^Bw|,       Wo,       Wo,       Wo,       Wo,       Wo,       Wo,       Wo,       Wo,       Wo
       Wo,       Wo,       Wo,       Wo,       Wo,       Wo,       Wo,       Wo,       Wo,       Wo,   Ww^Bw|,   Ww^Bw|,   Ww^Bw|,       Wo,       Dd,       Rd,       Rd,       Rd,       Dd,       Wo,   Ww^Bw|,   Ww^Bw|,   Ww^Bw|,       Wo,       Wo,       Wo,       Wo,       Wo,       Wo,       Wo,       Wo,       Wo
       Wo,       Wo,       Wo,       Wo,       Wo,       Wo,       Wo,       Wo,       Wo,       Wo,   Ww^Bw|,   Ww^Bw|,   Ww^Bw|,       Wo,       Dd,       Rd,       Rd,       Rd,       Dd,       Wo,   Ww^Bw|,   Ww^Bw|,   Ww^Bw|,       Wo,       Wo,       Wo,       Wo,       Wo,       Wo,       Wo,       Wo,       Wo
       Wo,       Wo,       Wo,       Wo,       Wo,       Wo,       Wo,       Wo,       Wo,       Wo,   Ww^Bw|,   Ww^Bw|,   Ww^Bw|,       Wo,       Dd,       Rd,       Rd,       Rd,       Dd,       Wo,   Ww^Bw|,   Ww^Bw|,   Ww^Bw|,       Wo,       Wo,       Wo,       Wo,       Wo,       Wo,       Wo,       Wo,       Wo
       Wo,       Wo,       Wo,       Wo,       Wo,       Wo,       Wo,       Wo,       Wo,       Wo,   Ww^Bw|,   Ww^Bw|,   Ww^Bw|,       Wo,       Dd,       Rd,       Rd,       Rd,       Dd,       Wo,   Ww^Bw|,   Ww^Bw|,   Ww^Bw|,       Wo,       Wo,       Wo,       Wo,       Wo,       Wo,       Wo,       Wo,       Wo
       Wo,       Wo,       Wo,       Wo,       Wo,       Wo,       Wo,       Wo,       Wo,       Wo,   Ww^Bw|,   Ww^Bw|,   Ww^Bw|,       Wo,       Dd,       Rd,       Rd,       Rd,       Dd,       Wo,   Ww^Bw|,   Ww^Bw|,   Ww^Bw|,       Wo,       Wo,       Wo,       Wo,       Wo,       Wo,       Wo,       Wo,       Wo
       Wo,       Wo,       Wo,       Wo,       Wo,       Wo,       Wo,       Wo,       Wo,       Wo,   Ww^Bw|,   Ww^Bw|,   Ww^Bw|,       Wo,       Dd,       Rd,       Rd,       Rd,       Dd,       Wo,   Ww^Bw|,   Ww^Bw|,   Ww^Bw|,       Wo,       Wo,       Wo,       Wo,       Wo,       Wo,       Wo,       Wo,       Wo
       Wo,       Wo,       Wo,       Wo,       Wo,       Wo,       Wo,       Wo,       Wo,       Wo,   Ww^Bw|,   Ww^Bw|,   Ww^Bw|,       Wo,       Dd,       Rd,       Rd,       Rd,       Dd,       Wo,   Ww^Bw|,   Ww^Bw|,   Ww^Bw|,       Wo,       Wo,       Wo,       Wo,       Wo,       Wo,       Wo,       Wo,       Wo
       Wo,       Wo,       Wo,       Wo,       Wo,       Wo,       Wo,       Wo,       Wo,       Wo,   Ww^Bw|,   Ww^Bw|,   Ww^Bw|,       Wo,       Dd,       Rd,       Rd,       Rd,       Dd,       Wo,   Ww^Bw|,   Ww^Bw|,   Ww^Bw|,       Wo,       Wo,       Wo,       Wo,       Wo,       Wo,       Wo,       Wo,       Wo
       Wo,       Wo,       Wo,       Wo,       Wo,       Wo,       Wo,       Wo,       Wo,       Wo,   Ww^Bw|,   Ww^Bw|,   Ww^Bw|,       Wo,       Dd,       Rd,       Rd,       Rd,       Dd,       Wo,   Ww^Bw|,   Ww^Bw|,   Ww^Bw|,       Wo,       Wo,       Wo,       Wo,       Wo,       Wo,       Wo,       Wo,       Wo
       Wo,       Wo,       Wo,       Wo,       Wo,       Wo,       Wo,       Wo,       Wo,       Wo,   Ww^Bw|,   Ww^Bw|,   Ww^Bw|,       Wo,       Dd,       Rd,       Rd,       Rd,       Dd,       Wo,   Ww^Bw|,   Ww^Bw|,   Ww^Bw|,       Wo,       Wo,       Wo,       Wo,       Wo,       Wo,       Wo,       Wo,       Wo
       Ww,       Ww,       Ww,       Wo,       Wo,       Wo,       Wo,       Wo,       Wo,       Wo,   Ww^Bw|,   Ww^Bw|,   Ww^Bw|,       Wo,       Dd,       Rd,       Rd,       Rd,       Dd,       Wo,   Ww^Bw|,   Ww^Bw|,   Ww^Bw|,       Wo,       Wo,       Wo,       Wo,       Wo,       Wo,       Wo,       Wo,       Wo
       Ww,       Ww,       Ww,       Ww,       Ww,       Wo,       Wo,       Wo,       Wo,       Wo,   Ww^Bw|,   Ww^Bw|,   Ww^Bw|,       Ww,       Dd,       Rd,       Rd,       Rd,       Dd,       Wo,   Ww^Bw|,   Ww^Bw|,   Ww^Bw|,       Wo,       Ww,       Wo,       Ww,       Wo,       Ww,       Wo,       Wo,       Wo
   Dd,   Dd^Vdt,       Dd,       Ww,       Ww,       Ww,       Ww,       Ww,       Ww,       Ww,   Ww^Bw|,   Ww^Bw|,   Ww^Bw|,       Dd,       Dd,       Rd,       Rd,       Rd,       Dd,       Ww,   Ww^Bw|,   Ww^Bw|,   Ww^Bw|,       Ww,       Ww,       Ww,       Ww,       Ww,       Ww,       Ww,       Ww,       Ww
       Gg,       Gg,       Gg,       Ww,       Ww,       Ww,       Ww,       Ww,       Ww,   Dd^Vda,   Ww^Bw|,   Ww^Bw|,   Ww^Bw|,   Dd^Vda,       Re,       Rd,       Re,       Rd,       Re,       Dd,   Ww^Bw|,   Ww^Bw|,   Ww^Bw|,       Ww,       Ww,       Ww,       Ww,       Ww,   Dd^Vdt,       Ww,       Ww,       Ww
       Gg,       Gg,       Gg,       Gg,       Gg,       Ww,       Gg,       Ww,       Gg,       Dd,       Dd,   Ww^Bw|,       Dd,       Dd,       Re,       Re,       Re,       Re,       Re,   Dd^Vda,   Ww^Bw|,   Ww^Bw|,   Ww^Bw|,   Dd^Vda,       Gg,       Ww,       Gg,       Dd,       Gg,       Dd,       Dd,       Dd
       Gg,       Gg,       Gg,       Gg,       Gg,       Gg,       Gg,       Gg,       Gg,       Gg,       Gg,       Dd,       Gg,       Gg,       Re,       Re,       Ce,       Re,       Re,       Dd,       Dd,   Ww^Bw|,       Dd,       Dd,       Gg,       Gg,       Gg,       Gg,       Gg,       Dd,       Gg,       Gg
       Gg,       Gg,       Gg,       Gg,       Gg,       Gg,       Gg,       Gg,       Gg,       Gg,       Gg,       Gg,       Gg,       Gg,       Re,       Ce,     1 Ke,       Ce,       Re,       Gg,       Gg,       Dd,       Gg,       Gg,       Gg,       Gg,       Gg,       Gg,       Gg,       Gg,       Gg,       Gg
       Gg,       Gg,       Gg,       Gg,       Gg,       Gg,       Gg,       Gg,       Gg,       Gg,       Gg,       Gg,       Gg,       Gg,       Re,       Ce,       Ce,       Ce,       Re,       Gg,       Gg,       Gg,       Gg,       Gg,       Gg,       Gg,       Gg,       Gg,       Gg,       Gg,       Gg,       Gg
       Gg,       Gg,       Gg,       Gg,       Gg,       Gg,       Gg,       Gg,       Gg,       Gg,       Gg,       Gg,       Gg,       Gg,       Re,       Ce,       Ce,       Ce,       Re,       Gg,       Gg,       Gg,       Gg,       Gg,       Gg,       Gg,       Gg,       Gg,       Gg,       Gg,       Gg,       Gg
