border_size=1
usage=map

Md          , Md          , Ce          , Md          , Md          , Hh          , Md          , Hh          , Md          , Md          , Md          , Md          , Md          , Uu          , Md          , Md          , Md          , Md          , Md          , Md          , Hd          , Hd          
Md          , Md          , Ce          , Hd          , Md          , Hh^Vhh      , Md          , Hh          , Md          , Md          , Md          , Md          , Md          , Uu^Vu       , Md          , Md          , Md          , Md          , Md          , Hd          , Md          , Hd          
Ce          , Ce          , 3 Ke        , Ce          , Hd          , Md          , Hd          , Hd          , Hd          , Hd          , Hd          , Md          , Md          , Md          , Md          , Md          , Chr         , Chr         , Chr         , Md          , Md          , Hd          
Ce          , Ce          , Ce          , Ce          , Md          , Hd          , Hh^Vhh      , Hh^Vhh      , Ww          , Ww          , Ww          , Hd          , Hd          , Hd          , Re          , Hd          , Chr         , 2 Kh        , Chr         , Md          , Md          , Md          
Md          , Md          , Md          , Hd          , Md          , Hd          , Hd          , Hd          , Ww          , Wo          , Ww          , Hh^Vhh      , Hh          , Re          , Hh          , Re          , Hd          , Chr         , Md          , Md          , Md          , Hd          
Hd          , Hd          , Hd          , Md          , Md          , Md          , Md          , Hd          , Hd          , Ww          , Hh          , Hh          , Re          , Re          , Hh          , Hh^Vhh      , Hh          , Hd          , Hd          , Md          , Md          , Md          
Hh          , Hh^Vhh      , Hd          , Hd          , Hd          , Hd          , Hd          , Hd          , Hh          , Hh          , Hh          , Re          , Hh          , Hh          , Hh          , Hh          , Hh          , Hh          , Hd          , Uu^Vu       , Md          , Md          
Hh          , Hh          , Hh          , Hh          , Hh          , Hh          , Hh          , Hh          , Hh          , Hh          , Re          , Re          , Hh          , Hh          , Hh          , Hh          , Hd          , Hd          , Md          , Md          , Md          , Md          
Re          , Re          , Hh          , Hh          , Gg^Ve       , Hh          , Hh          , Hh          , Hh          , Re          , Hh          , Hh          , Hh          , Hh          , Hh          , Hh          , Hd          , Md          , Md          , Md          , Hd          , Hd          
Re          , Re          , Re          , Hh          , Re          , Hh          , Hh          , Hh          , Re          , Re          , Hh          , Hh          , Hh          , Hh          , Hh          , Hh^Vhh      , Hd          , Md          , Md          , Md          , Md          , Hd          
Re          , Re          , Re          , Re          , Re          , Re          , Re          , Hh          , Re          , Hh          , Hh          , Hh          , Hh          , Hh          , Hh          , Hh          , Hd          , Md          , Md          , Md          , Hd          , Hd          
Hh          , Hh          , Hh          , Hh^Vhh      , Hh          , Re          , Re          , Hh^Fds      , Re          , Hh          , Hh          , Hh          , Hh          , Hh          , Hh          , Hd          , Md          , Md          , Md          , Hd          , Hh          , Hh          
Hh          , Hh          , Hh          , Hh          , Hh          , Hh          , Hh          , Re          , Re          , Re          , Re          , Hh^Vhh      , Hh          , Hh          , Hh          , Hd          , Md          , Md          , Md          , Hd          , Hh          , Hh          
Hh          , Hh          , Hh          , Hh          , Hh          , Hh          , Hh          , Hh          , Hh          , Re          , Re          , Re          , Re          , Hh          , Hh          , Hd          , Hd          , Md          , Hd          , Hd          , Hh^Vhh      , Hh          
Hh          , Hh          , Hh          , Hh          , Hh          , Hh          , Hh          , Hh          , Hh          , Hh          , Hh          , Hh          , Hh          , Re          , Re          , Hh          , Hh          , Hd          , Hh          , Hh          , Hh^Fms      , Hh          
Hh          , Hh          , Hd          , Hd          , Hd          , Hh          , Hh          , Hh          , Hh          , Hh^Vhh      , Hh          , Hh          , Hh          , Re          , Re          , Re          , Re          , Hh          , Hh          , Hh          , Hh^Fms      , Hh^Fms      
Hd          , Hd          , Md          , Md          , Md          , Hd          , Hd          , Hh          , Hh          , Hh          , Hh^Vhh      , Hh          , Hh          , Hh          , Hh          , Re          , Re          , Re          , Re          , Hh          , Hh          , Hh^Fms      
Md          , Md          , Md          , Md          , Md          , Md          , Md          , Hd          , Hd          , Hd          , Hd          , Hd          , Hd          , Hh          , Hd          , Hh          , Re          , 1 Re        , Re          , Re          , Hh          , Hh^Fms      
Md          , Md          , Md          , Md          , Md          , Md          , Md          , Md          , Md          , Md          , Md          , Md          , Md          , Hd          , Md          , Hd          , Ww          , Ww          , Ww          , Re          , Re          , Re          
Md          , Md          , Md          , Md          , Md          , Md          , Md          , Md          , Md          , Md          , Md          , Md          , Md          , Md          , Md          , Hd          , Ww          , Ww          , Ww          , Re          , Re          , Re          
Md          , Md          , Md          , Md          , Md          , Md          , Md          , Md          , Md          , Md          , Md          , Md          , Md          , Md          , Md          , Hd          , Hd          , Ww          , Hh          , Re          , Re          , Re          
Md          , Md          , Md          , Md          , Md          , Md          , Md          , Md          , Md          , Md          , Md          , Md          , Md          , Md          , Md          , Md          , Hd          , Ww          , Hh          , Re          , Re          , Re          
