border_size=1
usage=map

       Gg,       Gg,       Gg,       Gg,       Gg,       Gg,       Gg,       Gg,       Gg,    Gs^Ft,    Gs^Ft,    Gs^Ft,       Dd,       Dd,       Dd,       Dd,       Dd,       Dd,       Dd,    Gs^Ft,    Gs^Ft,    Gs^Ft,       Gg,       Gg,       Gg,       Gg,       Gg,       Gg,       Gg,       Gg,       Gg,       Gg
       Gg,       Gg,       Gg,       Gg,       Gg,       Gg,       Gg,       Gg,       Gg,    Gs^Ft,    Gs^Ft,    Gs^Ft,       Dd,       Dd,       Dd,       Dd,       Dd,       Dd,       Dd,    Gs^Ft,    Gs^Ft,    Gs^Ft,       Gg,       Gg,       Gg,       Gg,       Gg,       Gg,       Gg,       Gg,       Gg,       Gg
       Gg,       Gg,       Gg,       Gg,       Gg,       Gg,       Gg,       Gg,       Rd,    Gs^Ft,    Gs^Ft,    Gs^Ft,    Dd^Do,       Dd,       Rr,       Rr,       Rr,       Dd,    Dd^Do,    Gs^Ft,    Gs^Ft,    Gs^Ft,       Rd,       Gg,       Gg,       Gg,       Gg,       Gg,       Gg,       Gg,       Gg,       Gg
       Gg,       Gg,       Gg,       Gg,       Gg,       Gg,       Gg,    Gg^Ve,       Rd,    Gs^Ft,    Gs^Ft,    Gs^Ft,    Dd^Do,       Rr,       Ch,     1 Kh,       Ch,       Rr,    Dd^Do,    Gs^Ft,    Gs^Ft,    Gs^Ft,       Rd,    Gg^Ve,       Gg,       Gg,       Gg,       Gg,       Gg,       Gg,       Gg,       Gg
       Gg,       Gg,       Gg,       Gg,       Gg,       Gg,       Gg,       Gg,       Rd,    Gs^Ft,    Gs^Ft,    Gs^Ft,    Dd^Do,       Rr,       Rr,       Ch,       Rr,       Rr,    Dd^Do,    Gs^Ft,    Gs^Ft,    Gs^Ft,       Rd,       Gg,       Gg,       Gg,       Gg,       Gg,       Gg,       Gg,       Gg,       Gg
       Gg,       Gg,       Gg,       Gg,       Gg,       Gg,       Gg,    Gg^Ve,       Rd,    Gs^Ft,    Gs^Ft,    Gs^Ft,    Dd^Do,       Rr,       Rr,       Rr,       Rr,       Rr,    Dd^Do,    Gs^Ft,    Gs^Ft,    Gs^Ft,       Rd,    Gg^Ve,       Gg,       Gg,       Gg,       Gg,       Gg,       Gg,       Gg,       Gg
       Gg,       Gg,       Gg,       Gg,       Gg,       Gg,       Gg,       Gg,       Rd,    Gs^Ft,    Gs^Ft,    Gs^Ft,    Dd^Do,       Rr,       Rr,       Rr,       Rr,       Rr,    Dd^Do,    Gs^Ft,    Gs^Ft,    Gs^Ft,       Rd,       Gg,       Gg,       Gg,       Gg,       Gg,       Gg,       Gg,       Gg,       Gg
       Gg,       Gg,       Gg,       Gg,       Gg,       Gg,       Gg,    Gg^Ve,       Rd,    Gs^Ft,    Gs^Ft,    Gs^Ft,    Dd^Do,       Rr,       Rr,       Rr,       Rr,       Rr,    Dd^Do,    Gs^Ft,    Gs^Ft,    Gs^Ft,       Rd,    Gg^Ve,       Gg,       Gg,       Gg,       Gg,       Gg,       Gg,       Gg,       Gg
       Gg,       Gg,       Gg,       Gg,       Gg,       Gg,       Gg,       Gg,       Rd,    Gs^Ft,    Gs^Ft,    Gs^Ft,    Dd^Do,       Rr,       Rr,       Rr,       Rr,       Rr,    Dd^Do,    Gs^Ft,    Gs^Ft,    Gs^Ft,       Rd,       Gg,       Gg,       Gg,       Gg,       Gg,       Gg,       Gg,       Gg,       Gg
       Gg,       Gg,       Gg,       Gg,       Gg,       Gg,       Gg,    Gg^Ve,       Rd,    Gs^Ft,    Gs^Ft,    Gs^Ft,    Dd^Do,       Rr,       Rr,       Rr,       Rr,       Rr,    Dd^Do,    Gs^Ft,    Gs^Ft,    Gs^Ft,       Rd,    Gg^Ve,       Gg,       Gg,       Gg,       Gg,       Gg,       Gg,       Gg,       Gg
       Gg,       Gg,       Gg,       Gg,       Gg,       Gg,       Gg,       Gg,       Rd,    Gs^Ft,    Gs^Ft,    Gs^Ft,    Dd^Do,       Rr,       Rr,       Rr,       Rr,       Rr,    Dd^Do,    Gs^Ft,    Gs^Ft,    Gs^Ft,       Rd,       Gg,       Gg,       Gg,       Gg,       Gg,       Gg,       Gg,       Gg,       Gg
       Gg,       Gg,       Gg,       Gg,       Gg,       Gg,       Gg,    Gg^Ve,       Rd,    Gs^Ft,    Gs^Ft,    Gs^Ft,    Dd^Do,       Rr,       Rr,       Rr,       Rr,       Rr,    Dd^Do,    Gs^Ft,    Gs^Ft,    Gs^Ft,       Rd,    Gg^Ve,       Gg,       Gg,       Gg,       Gg,       Gg,       Gg,       Gg,       Gg
       Gg,       Gg,       Gg,       Gg,       Gg,       Gg,       Gg,       Gg,       Rd,    Gs^Ft,    Gs^Ft,    Gs^Ft,    Dd^Do,       Rr,       Rr,       Rr,       Rr,       Rr,    Dd^Do,    Gs^Ft,    Gs^Ft,    Gs^Ft,       Rd,       Gg,       Gg,       Gg,       Gg,       Gg,       Gg,       Gg,       Gg,       Gg
       Gg,       Gg,   Dd^Vda,       Gg,   Dd^Vda,       Gg,   Dd^Vda,       Gg,       Rd,    Gs^Ft,   Dd^Vda,    Gs^Ft,    Dd^Do,       Rr,       Rr,       Rr,       Rr,       Rr,    Dd^Do,    Gs^Ft,   Dd^Vda,    Gs^Ft,       Rd,       Gg,   Dd^Vda,       Gg,   Dd^Vda,       Gg,   Dd^Vda,       Gg,   Dd^Vda,   Dd
       Rr,       Rr,       Rr,       Rr,       Rr,       Rr,       Rr,       Rr,       Rr,       Rr,       Rr,       Rr,       Rr,       Rr,       Ww,   Ww^Bw|,       Ww,       Rr,       Rr,       Rr,       Rr,       Rr,       Rr,       Rr,       Rr,       Rr,       Rr,       Rr,       Rr,       Rr,       Rr,       Rr
       Rr,       Rr,       Rr,       Rr,       Rr,       Rr,       Rr,       Rr,       Rr,       Rr,       Rr,       Rr,       Rr,       Ww,       Wo,   Ww^Bw|,       Wo,       Ww,       Rr,       Rr,       Rr,       Rr,       Rr,       Rr,       Rr,       Rr,       Rr,       Rr,       Rr,       Rr,       Rr,       Rr
       Rr,       Rr,       Rr,       Rr,       Rr,       Rr,       Rr,       Rr,       Rr,       Rr,       Rr,       Rr,       Rr,       Ww,       Wo,   Ww^Bw|,       Wo,       Ww,       Rr,       Rr,       Rr,       Rr,       Rr,       Rr,       Rr,       Rr,       Rr,       Rr,       Rr,       Rr,       Rr,       Rr
       Rr,       Rr,       Rr,       Rr,       Rr,       Rr,       Rr,       Rr,       Rr,       Rr,       Rr,       Rr,       Rr,       Ww,       Ww,   Ww^Bw|,       Ww,       Ww,       Rr,       Rr,       Rr,       Rr,       Rr,       Rr,       Rr,       Rr,       Rr,       Rr,       Rr,       Rr,       Rr,       Rr
       Rr,       Rr,   Dd^Vda,       Rr,   Dd^Vda,       Rr,   Dd^Vda,       Rr,       Rd,       Rr,   Dd^Vda,       Rr,    Dd^Do,       Rr,       Rr,   Ww^Bw|,       Rr,       Rr,    Dd^Do,       Rr,   Dd^Vda,       Rr,       Rd,       Rr,   Dd^Vda,       Rr,   Dd^Vda,       Rr,   Dd^Vda,       Rr,   Dd^Vda,   Dd
       Gg,       Gg,       Gg,       Gg,       Gg,       Gg,       Gg,       Gg,       Rd,    Gs^Ft,    Gs^Ft,    Gs^Ft,    Dd^Do,       Rr,       Rr,       Rr,       Rr,       Rr,    Dd^Do,    Gs^Ft,    Gs^Ft,    Gs^Ft,       Rd,       Gg,       Gg,       Gg,       Gg,       Gg,       Gg,       Gg,       Gg,       Gg
       Gg,       Gg,       Gg,       Gg,       Gg,       Gg,       Gg,       Gg,       Rd,    Gs^Ft,    Gs^Ft,    Gs^Ft,    Dd^Do,       Rr,       Rr,       Rr,       Rr,       Rr,    Dd^Do,    Gs^Ft,    Gs^Ft,    Gs^Ft,       Rd,       Gg,       Gg,       Gg,       Gg,       Gg,       Gg,       Gg,       Gg,       Gg
       Gg,       Gg,       Gg,       Gg,       Gg,       Gg,       Gg,    Gg^Ve,       Rd,    Gs^Ft,    Gs^Ft,    Gs^Ft,    Dd^Do,       Rr,       Rr,       Rr,       Rr,       Rr,    Dd^Do,    Gs^Ft,    Gs^Ft,    Gs^Ft,       Rd,    Gg^Ve,       Gg,       Gg,       Gg,       Gg,       Gg,       Gg,       Gg,       Gg
       Gg,       Gg,       Gg,       Gg,       Gg,       Gg,       Gg,       Gg,       Rd,    Gs^Ft,    Gs^Ft,    Gs^Ft,    Dd^Do,       Rr,       Rr,       Rr,       Rr,       Rr,    Dd^Do,    Gs^Ft,    Gs^Ft,    Gs^Ft,       Rd,       Gg,       Gg,       Gg,       Gg,       Gg,       Gg,       Gg,       Gg,       Gg
       Gg,       Gg,       Gg,       Gg,       Gg,       Gg,       Gg,    Gg^Ve,       Rd,    Gs^Ft,    Gs^Ft,    Gs^Ft,    Dd^Do,       Rr,       Rr,       Rr,       Rr,       Rr,    Dd^Do,    Gs^Ft,    Gs^Ft,    Gs^Ft,       Rd,    Gg^Ve,       Gg,       Gg,       Gg,       Gg,       Gg,       Gg,       Gg,       Gg
       Gg,       Gg,       Gg,       Gg,       Gg,       Gg,       Gg,       Gg,       Rd,    Gs^Ft,    Gs^Ft,    Gs^Ft,    Dd^Do,       Rr,       Rr,       Rr,       Rr,       Rr,    Dd^Do,    Gs^Ft,    Gs^Ft,    Gs^Ft,       Rd,       Gg,       Gg,       Gg,       Gg,       Gg,       Gg,       Gg,       Gg,       Gg
       Gg,       Gg,       Gg,       Gg,       Gg,       Gg,       Gg,    Gg^Ve,       Rd,    Gs^Ft,    Gs^Ft,    Gs^Ft,    Dd^Do,       Rr,       Rr,       Rr,       Rr,       Rr,    Dd^Do,    Gs^Ft,    Gs^Ft,    Gs^Ft,       Rd,    Gg^Ve,       Gg,       Gg,       Gg,       Gg,       Gg,       Gg,       Gg,       Gg
       Gg,       Gg,       Gg,       Gg,       Gg,       Gg,       Gg,       Gg,       Rd,    Gs^Ft,    Gs^Ft,    Gs^Ft,    Dd^Do,       Rr,       Rr,       Rr,       Rr,       Rr,    Dd^Do,    Gs^Ft,    Gs^Ft,    Gs^Ft,       Rd,       Gg,       Gg,       Gg,       Gg,       Gg,       Gg,       Gg,       Gg,       Gg
       Gg,       Gg,       Gg,       Gg,       Gg,       Gg,       Gg,    Gg^Ve,       Rd,    Gs^Ft,    Gs^Ft,    Gs^Ft,    Dd^Do,       Rr,       Rr,       Rr,       Rr,       Rr,    Dd^Do,    Gs^Ft,    Gs^Ft,    Gs^Ft,       Rd,    Gg^Ve,       Gg,       Gg,       Gg,       Gg,       Gg,       Gg,       Gg,       Gg
       Gg,       Gg,       Gg,       Gg,       Gg,       Gg,       Gg,       Gg,       Rd,    Gs^Ft,    Gs^Ft,    Gs^Ft,    Dd^Do,       Rr,       Ch,       Ch,       Ch,       Rr,    Dd^Do,    Gs^Ft,    Gs^Ft,    Gs^Ft,       Rd,       Gg,       Gg,       Gg,       Gg,       Gg,       Gg,       Gg,       Gg,       Gg
       Gg,       Gg,       Gg,       Gg,       Gg,       Gg,       Gg,    Gg^Ve,       Rd,    Gs^Ft,    Gs^Ft,    Gs^Ft,    Dd^Do,       Rr,       Rr,     2 Kh,       Rr,       Rr,    Dd^Do,    Gs^Ft,    Gs^Ft,    Gs^Ft,       Rd,    Gg^Ve,       Gg,       Gg,       Gg,       Gg,       Gg,       Gg,       Gg,       Gg
       Gg,       Gg,       Gg,       Gg,       Gg,       Gg,       Gg,       Gg,       Gg,    Gs^Ft,    Gs^Ft,    Gs^Ft,       Dd,       Dd,       Dd,       Rr,       Dd,       Dd,       Dd,    Gs^Ft,    Gs^Ft,    Gs^Ft,       Gg,       Gg,       Gg,       Gg,       Gg,       Gg,       Gg,       Gg,       Gg,       Gg
       Gg,       Gg,       Gg,       Gg,       Gg,       Gg,       Gg,       Gg,       Gg,    Gs^Ft,    Gs^Ft,    Gs^Ft,       Dd,       Dd,       Dd,       Rr,       Dd,       Dd,       Dd,    Gs^Ft,    Gs^Ft,    Gs^Ft,       Gg,       Gg,       Gg,       Gg,       Gg,       Gg,       Gg,       Gg,       Gg,       Gg
