border_size=1
usage=map

       Wo,       Wo,       Wo,       Wo,       Wo,       Ai,       Ai,       Ai,       Ai,       Ai,       Ai,       Ai,       Ai,   Aa^Fpa,   Aa^Fpa,   Aa^Fpa,   Aa^Fpa,   Aa^Fpa,   Aa^Fpa,   Aa^Fpa,   Aa^Fpa,   Aa^Fpa,   Aa^Fpa,   Aa^Fpa,   Aa^Fpa,       Ha,       Ha,       Ha,       Ha,       Ha,   Aa^Fpa,       Ha,       Ha,       Ha,       Ha,       Ha,       Ha,       Ha,       Ha,       Ha,       Ha,       Ha
       Wo,       Wo,       Wo,       Wo,       Wo,       Ai,       Ai,       Ai,       Ai,       Ai,       Ai,       Ai,       Ai,   Aa^Fpa,   Aa^Fpa,   Aa^Fpa,   Aa^Fpa,   Aa^Fpa,   Aa^Fpa,   Aa^Fpa,   Aa^Fpa,   Aa^Fpa,   Aa^Fpa,   Aa^Fpa,   Aa^Fpa,       Ha,       Ha,       Ha,       Ha,       Ha,   Aa^Fpa,       Ha,       Ha,       Ha,       Ha,       Ha,       Ha,       Ha,       Ha,       Ha,       Ha,       Ha
       Wo,       Wo,       Wo,       Wo,       Wo,       Ai,       Ai,       Ai,       Ai,       Ai,       Ai,       Ai,       Ai,       Ai,       Ai,   Aa^Fpa,   Aa^Fpa,   Aa^Fpa,   Aa^Fpa,   Aa^Fpa,   Aa^Fpa,   Aa^Vha,   Aa^Fpa,   Aa^Fpa,   Aa^Fpa,   Aa^Fpa,       Ha,       Ha,       Ha,   Aa^Fpa,   Aa^Vha,   Aa^Fpa,       Ha,       Ha,       Ha,       Ha,       Ha,       Ha,       Ha,       Ha,       Ha,       Ha
       Wo,       Wo,       Wo,       Wo,       Ai,       Ai,       Ai,       Ai,       Wo,       Wo,       Wo,       Ai,       Ai,       Ai,       Ai,       Ai,   Aa^Fpa,   Aa^Fpa,   Aa^Fpa,   Aa^Fpa,   Aa^Fpa,   Aa^Fpa,   Aa^Fpa,   Aa^Fpa,   Aa^Vha,   Aa^Fpa,      Chr,      Chr,      Chr,   Aa^Fpa,   Aa^Fpa,   Aa^Fpa,   Aa^Fpa,   Aa^Fpa,   Aa^Fpa,       Ha,       Ha,       Ha,       Ha,       Ha,       Ha,       Ha
       Wo,       Wo,       Wo,       Wo,       Ai,       Ai,       Ai,       Ai,       Wo,       Wo,       Wo,       Wo,       Wo,       Ai,       Ai,       Ai,       Ai,   Aa^Fpa,   Aa^Fpa,   Aa^Fpa,   Aa^Fpa,   Aa^Fpa,   Aa^Fpa,   Aa^Fpa,   Aa^Fpa,   Aa^Fpa,      Chr,     2 Kh,      Chr,       Ha,       Ha,   Aa^Fpa,   Aa^Fpa,   Aa^Fpa,   Aa^Vha,       Ha,       Ha,       Ha,       Ha,       Ha,       Ha,       Ha
       Ww,       Ww,       Ww,       Wo,       Wo,       Ai,       Ai,       Ai,       Ai,       Wo,       Wo,       Wo,       Wo,       Ww,       Ai,       Ai,       Ai,       Ai,       Ai,   Aa^Fpa,   Aa^Fpa,   Aa^Fpa,   Aa^Fpa,   Aa^Fpa,   Aa^Fpa,   Aa^Fpa,       Ha,      Chr,       Ha,       Ha,       Ha,   Aa^Fpa,   Aa^Fpa,   Aa^Fpa,       Ha,       Ha,       Ha,       Ha,       Ha,       Ha,       Ha,       Ha
       Ai,       Ai,       Ai,       Ww,       Ww,       Ww,       Ai,       Ai,       Ai,       Ai,       Ai,       Wo,       Ww,       Ww,       Ai,       Ai,       Ai,       Ai,   Aa^Fpa,   Aa^Fpa,   Aa^Fpa,   Aa^Fpa,       Ha,   Aa^Fpa,       Ha,       Ha,   Aa^Fpa,       Ha,       Ha,       Ha,       Ha,       Ha,       Ha,       Ha,       Ha,       Ha,       Ha,       Ha,       Ha,       Ha,       Ha,       Ha
       Ai,       Ai,       Ai,       Ww,       Ww,       Ww,       Ai,       Ai,       Ai,       Ai,       Ai,       Ai,       Ai,       Ai,       Ai,       Ai,       Ai,       Ai,   Aa^Fpa,   Aa^Fpa,       Ai,       Ha,       Ha,       Ha,       Ha,   Aa^Fpa,   Aa^Fpa,   Aa^Fpa,   Aa^Fpa,       Ha,       Ha,       Ha,       Ha,       Ha,   Aa^Fpa,       Ha,   Aa^Fpa,       Ha,       Ha,       Ha,       Ha,       Ha
       Ai,       Ai,       Ai,       Ww,       Ww,       Ww,       Ai,       Ai,       Ai,       Ai,       Ai,       Ai,       Ai,       Ai,       Ai,       Ai,       Ai,       Ai,       Ai,       Ai,       Ai,       Ha,       Ha,       Ha,       Ha,   Aa^Fpa,   Aa^Fpa,   Aa^Vha,   Aa^Fpa,   Aa^Fpa,       Ha,       Ha,       Ha,   Aa^Fpa,   Aa^Fpa,   Aa^Fpa,   Aa^Fpa,   Aa^Fpa,       Ha,       Ha,       Ha,       Ha
       Ai,       Ai,       Ai,       Ai,       Ai,       Ai,       Ai,       Ai,       Ai,       Ai,       Ww,       Ww,       Ai,       Ww,       Ai,       Ai,       Ai,       Ai,       Ai,       Ai,       Ai,       Ha,       Ha,       Ha,       Ha,       Ha,       Ha,   Aa^Fpa,   Aa^Fpa,   Aa^Fpa,   Aa^Fpa,       Ha,       Ha,   Aa^Fpa,   Aa^Fpa,   Aa^Fpa,   Aa^Vha,   Aa^Fpa,       Ha,       Ha,       Ha,       Ha
       Ai,       Ai,       Ai,       Ai,       Ai,       Ai,       Ai,       Ai,       Ai,       Ai,       Ai,       Ai,       Ai,       Ai,       Ai,       Ai,       Ai,       Ai,       Ai,       Ai,       Ai,       Ai,       Ha,       Ha,       Ha,       Ha,       Ha,       Ha,       Ha,   Aa^Vha,   Aa^Fpa,   Aa^Fpa,       Ha,       Ha,       Ha,   Aa^Fpa,   Aa^Fpa,   Aa^Fpa,   Aa^Fpa,       Ha,       Ha,       Ha
       Ai,       Ai,       Ai,       Ai,       Ai,       Ai,       Ai,       Ai,       Ai,       Ai,       Ai,       Ai,       Ai,       Ai,       Ai,       Ww,       Ww,       Ai,       Ai,       Ai,       Ai,       Ai,       Ha,       Ha,       Ha,       Ha,   Aa^Fpa,   Aa^Fpa,   Aa^Fpa,   Aa^Fpa,   Aa^Fpa,   Aa^Fpa,       Ha,       Ha,       Ha,   Aa^Fpa,   Aa^Fpa,   Aa^Fpa,   Aa^Vha,       Ha,       Ha,       Ha
       Ai,       Ai,       Ai,       Ai,       Ai,       Ai,       Wo,       Ai,       Wo,       Ai,       Ai,       Ai,       Ai,       Ai,       Ai,       Ai,       Ai,       Ai,       Ai,       Ai,       Ai,       Ai,       Ha,   Aa^Vha,       Ha,       Ha,   Aa^Fpa,   Aa^Fpa,   Aa^Fpa,       Ha,       Ha,       Ha,       Ha,       Ha,       Ha,       Ha,   Aa^Fpa,   Aa^Fpa,   Aa^Fpa,       Ha,       Ha,       Ha
       Ai,       Ai,       Ai,       Ai,       Wo,       Wo,       Ai,       Wo,       Wo,       Wo,       Wo,       Ai,       Ai,       Ai,       Ai,       Ai,       Ai,       Ai,       Ai,       Ai,       Ai,       Ha,   Aa^Fpa,   Aa^Fpa,   Aa^Fpa,       Ha,       Ha,   Aa^Fpa,       Ha,       Ha,   Aa^Fpa,       Ha,   Aa^Fpa,       Ha,       Ha,       Ha,       Ha,   Aa^Fpa,       Ha,       Ha,       Ha,       Ha
       Ai,       Ai,       Ai,       Ai,       Ai,       Ai,       Ai,       Wo,       Ww,       Ww,       Ww,       Wo,       Ai,       Ai,       Ai,       Ww,       Ai,       Ai,       Ai,       Ai,       Ai,       Ha,   Aa^Fpa,   Aa^Fpa,   Aa^Fpa,       Ha,       Ha,       Ha,       Ha,   Aa^Fpa,   Aa^Fpa,   Aa^Fpa,   Aa^Fpa,   Aa^Fpa,       Ha,       Ha,   Aa^Fpa,       Ha,       Ha,       Ha,       Ha,       Ha
       Ai,       Ai,       Ai,       Ai,       Ai,       Ai,       Ai,       Wo,       Wo,       Wo,       Ww,       Wo,       Ai,       Ai,       Ai,       Ww,       Wo,       Ai,       Ai,       Ai,       Ai,   Aa^Fpa,   Aa^Fpa,   Aa^Fpa,   Aa^Fpa,       Ha,      Chr,      Chr,      Chr,   Aa^Fpa,   Aa^Fpa,   Aa^Fpa,   Aa^Fpa,   Aa^Fpa,       Ha,   Aa^Fpa,   Aa^Fpa,   Aa^Fpa,       Ha,       Ha,       Ha,       Ha
       Ai,       Ai,       Ai,       Ai,       Ai,       Ai,       Ai,       Ai,       Ai,       Ai,       Ai,       Ai,       Ai,       Ai,       Ai,       Wo,       Wo,       Wo,       Ai,       Ai,       Ai,   Aa^Fpa,   Aa^Fpa,   Aa^Vha,   Aa^Fpa,       Ha,      Chr,     3 Kh,      Chr,       Ha,       Ha,   Aa^Fpa,       Ha,       Ha,       Ha,   Aa^Fpa,   Aa^Fpa,   Aa^Fpa,      Chr,       Ha,       Ha,       Ha
       Ai,       Ai,       Ai,       Ai,       Ai,       Ai,       Ai,       Ai,       Ai,       Ai,       Ai,       Ai,       Ai,       Ai,       Ai,       Wo,       Wo,       Ww,       Ai,       Ai,       Ai,       Ai,       Ai,   Aa^Fpa,   Aa^Fpa,       Ha,   Aa^Fpa,      Chr,   Aa^Fpa,       Ha,       Ha,       Ha,       Ha,       Ha,       Ha,   Aa^Fpa,   Aa^Fpa,      Chr,     4 Kh,      Chr,       Ha,       Ha
       Wo,       Wo,       Wo,       Ai,       Ai,       Ai,       Ai,       Ai,       Ai,       Ai,       Ai,       Ai,       Ai,       Ai,       Ai,       Ai,       Ai,       Ai,       Ai,       Ai,       Ai,       Ai,   Aa^Fpa,   Aa^Fpa,   Aa^Fpa,   Aa^Fpa,   Aa^Fpa,   Aa^Fpa,   Aa^Fpa,   Aa^Fpa,   Aa^Fpa,       Ha,       Ha,       Ha,       Ha,       Ha,       Ha,      Chr,      Chr,      Chr,       Ha,       Ha
       Wo,       Wo,       Wo,       Wo,       Wo,       Ai,       Ai,       Ai,       Ai,       Ai,       Ai,       Ai,       Wo,       Wo,       Ww,       Ai,       Ai,       Ai,       Ai,       Ai,       Ai,   Aa^Fpa,   Aa^Fpa,   Aa^Fpa,   Aa^Fpa,   Aa^Fpa,   Aa^Fpa,   Aa^Fpa,   Aa^Fpa,   Aa^Fpa,   Aa^Fpa,   Aa^Vha,   Aa^Fpa,       Ha,       Ha,       Ha,       Ha,       Ha,   Aa^Fpa,       Ha,       Ha,       Ha
       Wo,       Wo,       Wo,       Wo,       Wo,       Ai,       Ai,       Ai,       Ai,       Ai,       Ai,       Ai,       Wo,       Wo,       Wo,       Ww,       Wo,       Ww,       Ai,       Ai,       Ai,   Aa^Fpa,   Aa^Fpa,   Aa^Fpa,   Aa^Fpa,   Aa^Vha,   Aa^Fpa,   Aa^Fpa,   Aa^Fpa,   Aa^Fpa,   Aa^Fpa,   Aa^Fpa,   Aa^Fpa,   Aa^Fpa,   Aa^Fpa,       Ha,       Ha,   Aa^Fpa,   Aa^Fpa,   Aa^Fpa,       Ha,       Ha
       Wo,       Wo,       Wo,       Wo,       Wo,       Ai,       Ai,       Ai,       Ai,       Ai,       Ai,       Ai,       Wo,       Wo,       Wo,       Wo,       Wo,       Wo,       Ai,       Ai,       Ai,   Aa^Fpa,   Aa^Fpa,   Aa^Fpa,   Aa^Fpa,   Aa^Fpa,   Aa^Fpa,   Aa^Fpa,   Aa^Fpa,   Aa^Fpa,   Aa^Fpa,   Aa^Fpa,   Aa^Fpa,   Aa^Fpa,   Aa^Fpa,   Aa^Fpa,   Aa^Fpa,   Aa^Fpa,   Aa^Fpa,   Aa^Fpa,       Ha,       Ha
       Wo,       Wo,       Wo,       Wo,       Wo,       Wo,       Wo,       Ai,       Ai,       Ai,       Ai,       Ai,       Ai,       Wo,       Ai,       Wo,       Wo,       Wo,       Ai,       Ai,       Ai,       Ai,   Aa^Fpa,   Aa^Fpa,   Aa^Fpa,   Aa^Fpa,   Aa^Fpa,   Aa^Fpa,   Aa^Fpa,   Aa^Fpa,   Aa^Fpa,   Aa^Fpa,   Aa^Vha,   Aa^Fpa,   Aa^Fpa,   Aa^Fpa,   Aa^Fpa,       Ha,   Aa^Fpa,       Ha,       Ha,       Ha
       Wo,       Wo,       Wo,       Wo,       Wo,       Wo,       Wo,       Ai,       Ai,       Ai,       Wo,       Ai,       Ai,       Ai,       Ai,       Ai,       Ai,       Ai,       Ai,       Ww,       Ai,   Aa^Fpa,   Aa^Fpa,   Aa^Fpa,   Aa^Fpa,   Aa^Fpa,   Aa^Fpa,   Aa^Fpa,       Ai,   Aa^Fpa,   Aa^Fpa,   Aa^Fpa,   Aa^Fpa,   Aa^Fpa,   Aa^Fpa,   Aa^Fpa,   Aa^Fpa,   Aa^Fpa,   Aa^Fpa,   Aa^Fpa,   Aa^Fpa,   Aa^Fpa
       Wo,       Wo,       Wo,       Wo,       Wo,       Wo,       Wo,       Wo,       Ai,       Wo,       Ai,       Wo,       Wo,       Ai,       Ww,       Ai,       Ai,       Ai,       Ai,       Ai,   Aa^Fpa,   Aa^Fpa,   Aa^Fpa,   Aa^Fpa,   Aa^Fpa,   Aa^Fpa,       Ai,       Ai,       Ai,       Ai,       Ai,   Aa^Fpa,   Aa^Fpa,   Aa^Fpa,   Aa^Fpa,   Aa^Fpa,   Aa^Fpa,   Aa^Fpa,   Aa^Fpa,   Aa^Fpa,   Aa^Fpa,   Aa^Fpa
       Wo,       Wo,       Wo,       Wo,       Wo,       Wo,       Wo,       Wo,       Ai,       Ai,       Ai,       Ai,       Ai,       Ww,       Ww,       Ww,       Ai,       Ai,       Ai,   Aa^Fpa,       Ai,   Aa^Fpa,   Aa^Fpa,       Ai,       Ai,       Ai,       Ai,       Ai,       Ai,       Ai,       Ai,       Ai,       Ai,   Aa^Fpa,       Ai,       Ai,   Aa^Fpa,   Aa^Fpa,   Aa^Fpa,   Aa^Fpa,   Aa^Fpa,   Aa^Fpa
       Wo,       Wo,       Wo,       Wo,       Wo,       Wo,       Wo,       Wo,       Wo,       Ai,       Ai,       Ai,       Ai,       Ww,       Ww,       Ww,       Ai,       Ai,       Ai,       Ai,       Ai,       Ai,       Ai,       Ai,       Ai,       Ai,       Ai,       Ai,       Ai,       Ai,       Ai,       Ai,       Ai,       Ai,       Ai,       Ai,   Aa^Fpa,   Aa^Fpa,   Aa^Fpa,   Aa^Fpa,   Aa^Fpa,   Aa^Fpa
       Wo,       Wo,       Wo,       Wo,       Wo,       Wo,       Wo,       Wo,       Wo,       Wo,       Wo,       Ai,       Ai,       Ai,       Ai,       Ai,       Ce,       Ai,       Ai,       Ww,       Ww,       Ai,       Ai,       Ai,       Ai,       Ai,       Ai,       Ai,       Ai,       Ai,       Wo,       Ai,       Wo,       Ai,   Aa^Fpa,       Ai,   Aa^Fpa,   Aa^Fpa,   Aa^Fpa,   Aa^Fpa,   Aa^Fpa,   Aa^Fpa
       Wo,       Wo,       Wo,       Wo,       Wo,       Wo,       Wo,       Wo,       Wo,       Wo,       Wo,       Wo,       Ai,       Ai,       Ai,       Ce,     1 Ke,       Ce,       Ai,       Ww,       Ww,       Ww,       Ai,       Ai,       Ai,       Ai,       Wo,       Ai,       Ww,       Ai,       Ai,       Ai,       Ai,   Aa^Fpa,   Aa^Fpa,   Aa^Fpa,       Ai,   Aa^Fpa,   Aa^Fpa,   Aa^Fpa,   Aa^Fpa,   Aa^Fpa
       Wo,       Wo,       Wo,       Wo,       Wo,       Wo,       Wo,       Wo,       Wo,       Wo,       Wo,       Wo,       Wo,       Ai,       Ai,       Ce,       Ce,       Ce,       Ai,       Ai,       Ai,       Ai,       Ai,       Ai,       Ai,       Ai,       Ai,       Ai,       Ai,       Ai,       Ai,       Ai,       Ai,       Ai,       Wo,       Ai,       Ai,       Ai,       Ai,   Aa^Fpa,       Ai,       Ai
       Wo,       Wo,       Wo,       Wo,       Wo,       Wo,       Wo,       Wo,       Wo,       Wo,       Wo,       Wo,       Wo,       Ai,       Ai,       Ai,       Ai,       Ai,       Ai,       Ai,       Ai,       Ai,       Ai,       Ai,       Ai,       Ai,       Ai,       Ai,       Ai,       Ai,       Ai,       Ai,       Wo,       Ww,       Ww,       Ai,       Ai,       Ai,       Ai,       Ai,       Ai,       Ai
       Wo,       Wo,       Wo,       Wo,       Wo,       Wo,       Wo,       Wo,       Wo,       Wo,       Wo,       Wo,       Wo,       Wo,       Ai,       Ai,       Ai,       Ai,       Ai,       Ai,       Ai,       Ai,       Ai,       Ai,       Ai,       Ai,       Ai,       Ai,       Ai,       Ai,       Wo,       Ai,       Ai,       Ai,       Ww,       Ww,       Ww,       Ww,       Ai,       Ai,       Ai,       Ai
       Wo,       Wo,       Wo,       Wo,       Wo,       Wo,       Wo,       Wo,       Wo,       Wo,       Wo,       Wo,       Wo,       Wo,       Ai,       Ai,       Wo,       Wo,       Wo,       Wo,       Wo,       Ai,       Wo,       Ai,       Ai,       Ai,       Ai,       Ai,       Ai,       Wo,       Ai,       Wo,       Ai,       Ai,       Ai,       Ai,       Ai,       Ww,       Ai,       Ai,       Ai,       Ai
       Wo,       Wo,       Wo,       Wo,       Wo,       Wo,       Wo,       Wo,       Wo,       Wo,       Wo,       Wo,       Ai,       Ai,       Ai,       Ai,       Wo,       Wo,       Wo,       Wo,       Wo,       Wo,       Wo,       Wo,       Wo,       Ai,       Ai,       Ai,       Ai,       Ai,       Ai,       Ai,       Ai,       Ai,       Wo,       Ai,       Ai,       Ai,       Ai,       Ai,       Ai,       Ai
       Wo,       Wo,       Wo,       Wo,       Wo,       Wo,       Wo,       Wo,       Wo,       Wo,       Wo,       Wo,       Wo,       Ai,       Ai,       Ai,       Wo,       Wo,       Wo,       Wo,       Wo,       Wo,       Wo,       Wo,       Wo,       Ai,       Ai,       Ai,       Ai,       Ai,       Ai,       Ai,       Ai,       Ai,       Ai,       Ai,       Ai,       Ai,       Ai,       Wo,       Ai,       Ai
       Wo,       Wo,       Wo,       Wo,       Wo,       Wo,       Wo,       Wo,       Wo,       Wo,       Wo,       Wo,       Wo,       Wo,       Wo,       Wo,       Wo,       Wo,       Wo,       Ai,       Ai,       Wo,       Wo,       Wo,       Wo,       Ai,       Ai,       Ai,       Ai,       Ai,       Ai,       Ai,       Wo,       Wo,       Ai,       Ai,       Ai,       Ai,       Ai,       Wo,       Ai,       Ai
       Wo,       Wo,       Wo,       Wo,       Wo,       Wo,       Wo,       Wo,       Wo,       Wo,       Wo,       Wo,       Wo,       Wo,       Wo,       Wo,       Wo,       Wo,       Wo,       Wo,       Wo,       Ai,       Wo,       Wo,       Wo,       Ai,       Ai,       Ai,       Ai,       Ai,       Ai,       Wo,       Ai,       Ai,       Ai,       Ai,       Ai,       Ai,       Ai,       Ai,       Ai,       Ai
       Wo,       Wo,       Wo,       Wo,       Wo,       Wo,       Wo,       Wo,       Wo,       Wo,       Wo,       Wo,       Wo,       Wo,       Wo,       Wo,       Wo,       Wo,       Wo,       Wo,       Wo,       Wo,       Wo,       Wo,       Wo,       Ai,       Ai,       Ai,       Ai,       Ai,       Ai,       Ai,       Ai,       Ai,       Ai,       Ai,       Ai,       Ai,       Ai,       Ai,       Ai,       Ai
       Wo,       Wo,       Wo,       Wo,       Wo,       Wo,       Wo,       Wo,       Wo,       Wo,       Wo,       Wo,       Wo,       Wo,       Wo,       Wo,       Wo,       Wo,       Wo,       Wo,       Wo,       Wo,       Wo,       Wo,       Wo,       Ai,       Ai,       Ai,       Ai,       Ai,       Ai,       Ai,       Ai,       Ai,       Ai,       Ai,       Ai,       Ai,       Wo,       Ai,       Ai,       Ai
       Wo,       Wo,       Wo,       Wo,       Wo,       Wo,       Wo,       Wo,       Wo,       Wo,       Wo,       Wo,       Wo,       Wo,       Wo,       Wo,       Wo,       Wo,       Wo,       Wo,       Wo,       Wo,       Wo,       Wo,       Wo,       Wo,       Wo,       Ai,       Ai,       Ai,       Ai,       Ai,       Ww,       Ww,       Ww,       Ww,       Ww,       Wo,       Ww,       Ai,       Ai,       Ai
       Wo,       Wo,       Wo,       Wo,       Wo,       Wo,       Wo,       Wo,       Wo,       Wo,       Wo,       Wo,       Wo,       Wo,       Wo,       Wo,       Wo,       Wo,       Wo,       Wo,       Wo,       Wo,       Wo,       Wo,       Wo,       Wo,       Wo,       Ai,       Ai,       Ai,       Ww,       Ww,       Ai,       Ww,       Ww,       Wo,       Wo,       Ai,       Ai,       Ai,       Ai,       Ai
       Wo,       Wo,       Wo,       Wo,       Wo,       Wo,       Wo,       Wo,       Wo,       Wo,       Wo,       Wo,       Wo,       Wo,       Wo,       Wo,       Wo,       Wo,       Wo,       Wo,       Wo,       Wo,       Wo,       Wo,       Wo,       Wo,       Wo,       Ai,       Ai,       Ai,       Ww,       Ww,       Ai,       Ww,       Ww,       Wo,       Wo,       Ai,       Ai,       Ai,       Ai,       Ai
