border_size=1
usage=map

       Aa,       Aa,       Aa,       Aa,       Ha,       Ha,       Ha,       Ha,       Ha,       Ha,       Ha,       Ha,       Ha,       Ha,       Ha,       Ha,       Ha,       Ha,       Ha,       Ha,       Ha,       Ha,       Ha,       Ha,       Ha,       Ha,       Ha,       Ha,       Ha,       Ha,       Ha,       Ha
       Aa,       Aa,       Aa,       Aa,       Ha,       Ha,       Ha,       Ha,       Ha,       Ha,       Ha,       Ha,       Ha,       Ha,       Ha,       Ha,       Ha,       Ha,       Ha,       Ha,       Ha,       Ha,       Ha,       Ha,       Ha,       Ha,       Ha,       Ha,       Ha,       Ha,       Ha,       Ha
       Aa,       Aa,       Aa,       Aa,       Ha,       Ha,       Ha,       Ha,       Aa,       Ha,       Ha,       Ha,       Ha,       Ha,       Ha,       Ha,       Ha,       Ha,       Ha,       Ha,       Ha,       Ha,       Ha,       Ha,       Ha,       Ha,       Ha,       Ha,       Ha,       Ha,       Ha,       Ha
       Aa,       Aa,       Aa,       Aa,       Aa,       Ha,   Aa^Vea,       Ha,       Ha,       Ha,   Aa^Vha,       Ha,       Ha,   Aa^Vha,       Aa,       Ha,       Ha,       Ha,       Ha,       Ha,       Ha,       Ha,       Ha,   Aa^Vha,       Ha,       Ha,       Ha,       Ha,       Ha,       Ha,       Ha,       Ha
       Aa,       Aa,       Ha,       Aa,       Aa,       Ha,       Ha,       Ha,       Ha,       Ha,       Ha,       Ha,       Aa,       Aa,       Aa,       Aa,       Ha,       Ha,   Aa^Vea,       Ha,       Ha,       Ha,       Ha,       Ha,       Ha,       Ha,       Ha,       Ha,       Ha,       Ha,       Ha,       Ha
       Ha,       Ha,       Ha,       Ha,       Ha,       Ha,       Ha,       Ha,       Aa,       Ha,       Aa,       Aa,       Aa,       Aa,       Aa,       Aa,       Ha,       Ha,       Ha,       Ha,       Ha,       Ha,       Ha,       Ha,       Ha,       Ha,       Ha,   Aa^Vea,       Ha,       Ha,       Ha,       Ha
       Ha,       Ha,       Ha,   Aa^Vea,       Ha,       Aa,       Aa,       Aa,       Ch,       Aa,       Aa,       Aa,       Aa,       Aa,       Ha,       Ha,       Ha,       Ha,       Ha,       Ha,       Ha,       Ha,       Ha,   Aa^Vea,       Ha,       Ha,       Ha,       Ha,       Ha,       Ha,       Ha,       Ha
   Aa^Fpa,   Aa^Fpa,   Aa^Fpa,       Ha,       Aa,       Aa,       Aa,       Ch,     1 Kh,       Ch,       Aa,       Aa,       Aa,       Aa,       Ha,       Ha,       Ha,       Aa,       Ha,       Ha,       Ha,       Ha,       Ha,       Ha,       Ha,       Ha,       Ha,       Ha,       Ha,       Ha,       Ha,       Ha
   Aa^Fpa,   Aa^Fpa,   Aa^Fpa,   Aa^Fpa,   Aa^Fpa,       Aa,       Aa,       Ch,       Ch,       Ch,       Aa,       Aa,       Aa,       Ha,       Ha,       Ha,       Aa,       Aa,       Aa,       Ha,       Aa,       Ha,       Ha,       Ha,       Ha,       Ha,       Ha,       Ha,       Ha,       Ha,       Aa,       Aa
   Aa,   Aa^Vha,   Aa^Fpa,   Aa^Fpa,   Aa^Fpa,   Aa^Fpa,       Aa,       Aa,       Aa,       Aa,       Aa,       Aa,       Ha,       Ha,       Ha,       Ha,       Aa,       Aa,       Aa,       Aa,       Aa,       Ha,       Ha,       Ha,       Ha,       Aa,       Aa,       Ha,       Ha,   Aa^Vha,       Aa,       Aa
   Aa^Fpa,   Aa^Fpa,   Aa^Fpa,   Aa^Fpa,   Aa^Fpa,   Aa^Fpa,       Aa,       Aa,       Aa,       Aa,       Aa,       Aa,       Ha,   Aa^Vea,       Ha,       Ha,       Ha,       Ha,       Ha,       Ha,       Ha,       Ha,       Ha,       Ha,       Ha,       Aa,       Aa,       Aa,       Aa,       Aa,       Aa,       Aa
   Aa^Fpa,   Aa^Fpa,   Aa^Fpa,   Aa^Fpa,   Aa^Fpa,   Aa^Fpa,   Aa^Fpa,       Aa,       Aa,       Aa,       Aa,       Ha,       Ha,       Ha,   Aa^Vha,       Ha,       Ha,       Ha,   Aa^Vha,       Ha,       Ha,       Ha,       Ha,       Ha,       Ha,       Ha,       Aa,       Aa,       Aa,       Aa,       Aa,       Aa
   Aa^Fpa,   Aa^Fpa,   Aa^Fpa,   Aa^Fpa,   Aa^Fpa,   Aa^Fpa,   Aa^Fpa,       Aa,       Aa,       Aa,       Aa,       Ha,       Ha,       Ha,       Ha,       Ha,       Ha,       Ha,       Ha,       Ha,       Aa,       Ha,       Aa,       Ha,       Ha,       Ha,       Ha,       Ha,       Ha,       Aa,       Aa,       Aa
   Aa^Fpa,   Aa^Fpa,   Aa^Fpa,   Aa^Fpa,   Aa^Fpa,   Aa^Vha,   Aa^Fpa,   Aa^Fpa,       Aa,       Aa,       Aa,       Aa,       Aa,       Aa,       Aa,       Aa,       Aa,       Aa,       Aa,       Aa,       Aa,       Aa,       Aa,       Aa,       Aa,       Aa,       Ha,   Aa^Vha,       Ha,       Aa,       Aa,       Aa
   Aa^Fpa,   Aa^Fpa,   Aa^Fpa,   Aa^Fpa,   Aa^Fpa,   Aa^Fpa,   Aa^Fpa,   Aa^Fpa,       Aa,       Aa,       Aa,       Aa,       Aa,       Aa,       Aa,       Aa,       Aa,       Aa,   Aa^Vha,       Aa,       Aa,       Aa,       Aa,       Aa,       Aa,       Aa,       Aa,       Ha,       Aa,       Aa,       Aa,       Aa
   Aa^Fpa,   Aa^Fpa,   Aa^Fpa,   Aa^Fpa,   Aa^Vha,   Aa^Fpa,   Aa^Fpa,       Aa,       Aa,       Aa,       Aa,       Aa,       Aa,       Aa,       Aa,       Aa,       Aa,       Aa,       Aa,       Aa,       Aa,       Aa,       Aa,       Aa,       Aa,       Aa,       Aa,       Aa,       Aa,       Aa,       Aa,       Aa
   Aa^Fpa,   Aa^Fpa,   Aa^Vha,   Aa^Fpa,   Aa^Fpa,   Aa^Fpa,   Aa^Fpa,   Aa^Fpa,   Aa^Fpa,       Aa,       Aa,       Aa,       Aa,   Aa^Vha,       Aa,       Aa,       Aa,       Aa,       Aa,       Aa,       Aa,       Aa,       Aa,   Aa^Vha,       Aa,       Aa,       Aa,       Aa,       Ch,       Aa,       Aa,       Aa
   Aa^Fpa,   Aa^Fpa,   Aa^Fpa,   Aa^Fpa,   Aa^Fpa,   Aa^Fpa,   Aa^Fpa,   Aa^Fpa,   Aa^Fpa,   Aa^Fpa,       Aa,       Aa,       Aa,       Aa,       Aa,       Aa,       Aa,   Aa^Vea,       Aa,       Aa,       Aa,       Aa,       Aa,       Aa,       Aa,       Aa,       Aa,       Ch,     2 Kh,       Ch,       Aa,       Aa
   Aa^Fpa,   Aa^Fpa,   Aa^Vea,   Aa^Fpa,   Aa^Fpa,   Aa^Fpa,   Aa^Fpa,   Aa^Fpa,   Aa^Fpa,   Aa^Fpa,   Aa^Fpa,       Aa,       Aa,       Aa,       Aa,       Aa,       Aa,       Aa,       Aa,       Aa,       Aa,       Aa,       Aa,       Aa,       Aa,       Aa,       Aa,       Ch,       Ch,       Ch,       Aa,       Aa
   Aa^Fpa,   Aa^Fpa,   Aa^Fpa,   Aa^Fpa,   Aa^Fpa,   Aa^Fpa,   Aa^Fpa,   Aa^Fpa,   Aa^Fpa,   Aa^Fpa,   Aa^Fpa,       Aa,       Aa,       Aa,       Aa,       Aa,       Aa,       Aa,       Aa,       Aa,       Aa,       Aa,       Aa,       Aa,   Aa^Vea,       Aa,       Aa,       Aa,       Aa,       Aa,       Aa,       Aa
   Aa^Fpa,   Aa^Fpa,   Aa^Fpa,   Aa^Fpa,   Aa^Fpa,   Aa^Fpa,   Aa^Fpa,   Aa^Fpa,   Aa^Fpa,   Aa^Fpa,       Aa,       Aa,       Aa,       Aa,       Aa,       Aa,       Aa,       Aa,   Aa^Fpa,       Aa,       Aa,       Aa,       Aa,       Aa,       Aa,       Aa,       Aa,       Aa,       Aa,       Aa,       Aa,       Aa
   Aa^Fpa,   Aa^Fpa,   Aa^Fpa,   Aa^Fpa,   Aa^Vea,   Aa^Fpa,   Aa^Fpa,   Aa^Vea,   Aa^Fpa,       Aa,   Aa^Fpa,   Aa^Fpa,   Aa^Fpa,       Aa,       Aa,       Aa,       Aa,       Aa,       Aa,       Aa,       Aa,       Aa,       Aa,       Aa,       Aa,       Aa,       Aa,       Aa,       Aa,       Aa,       Aa,       Aa
   Aa^Fpa,   Aa^Fpa,   Aa^Fpa,   Aa^Fpa,   Aa^Fpa,   Aa^Fpa,   Aa^Fpa,   Aa^Fpa,   Aa^Fpa,   Aa^Fpa,   Aa^Fpa,   Aa^Fpa,   Aa^Fpa,   Aa^Fpa,   Aa^Fpa,       Aa,       Aa,       Aa,   Aa^Fpa,   Aa^Fpa,       Aa,       Aa,       Aa,       Aa,       Aa,       Aa,       Aa,       Aa,   Aa^Vea,       Aa,       Aa,       Aa
   Aa^Fpa,   Aa^Fpa,   Aa^Fpa,   Aa^Fpa,   Aa^Fpa,   Aa^Fpa,   Aa^Fpa,   Aa^Fpa,       Aa,   Aa^Fpa,   Aa^Fpa,   Aa^Fpa,   Aa^Fpa,   Aa^Fpa,   Aa^Fpa,   Aa^Fpa,   Aa^Fpa,   Aa^Fpa,   Aa^Fpa,       Aa,   Aa^Fpa,       Aa,       Aa,       Aa,       Aa,       Aa,       Aa,       Aa,       Aa,       Aa,       Aa,       Aa
   Aa^Fpa,   Aa^Fpa,   Aa^Fpa,   Aa^Fpa,   Aa^Fpa,   Aa^Fpa,   Aa^Fpa,   Aa^Fpa,   Aa^Fpa,       Aa,       Aa,       Aa,       Aa,   Aa^Fpa,   Aa^Fpa,   Aa^Fpa,   Aa^Vea,   Aa^Fpa,   Aa^Fpa,   Aa^Fpa,   Aa^Fpa,       Aa,       Aa,       Aa,       Aa,   Aa^Vea,       Aa,       Aa,       Aa,       Aa,       Aa,       Aa
   Aa^Fpa,   Aa^Fpa,   Aa^Fpa,   Aa^Fpa,   Aa^Fpa,   Aa^Fpa,   Aa^Fpa,   Aa^Fpa,   Aa^Fpa,   Aa^Fpa,       Aa,       Aa,       Aa,       Aa,   Aa^Fpa,   Aa^Fpa,   Aa^Fpa,   Aa^Fpa,   Aa^Fpa,   Aa^Fpa,   Aa^Fpa,   Aa^Fpa,       Aa,       Aa,       Aa,       Aa,       Aa,       Aa,       Aa,       Aa,       Aa,       Aa
   Aa^Fpa,   Aa^Fpa,   Aa^Fpa,   Aa^Fpa,   Aa^Fpa,   Aa^Fpa,   Aa^Fpa,   Aa^Fpa,   Aa^Fpa,   Aa^Fpa,       Aa,       Aa,   Aa^Fpa,   Aa^Fpa,   Aa^Fpa,   Aa^Fpa,       Aa,       Aa,   Aa^Fpa,   Aa^Vea,   Aa^Fpa,   Aa^Fpa,       Aa,       Aa,       Aa,       Aa,       Aa,       Aa,       Aa,       Aa,       Aa,       Aa
   Aa^Fpa,   Aa^Fpa,   Aa^Fpa,   Aa^Vea,   Aa^Fpa,   Aa^Fpa,       Ch,       Ch,       Ch,   Aa^Fpa,   Aa^Fpa,       Aa,   Aa^Fpa,   Aa^Fpa,   Aa^Fpa,   Aa^Fpa,       Aa,       Aa,   Aa^Fpa,   Aa^Fpa,   Aa^Fpa,       Aa,       Aa,       Aa,       Aa,       Aa,       Aa,       Aa,       Aa,       Aa,       Aa,       Aa
   Aa^Fpa,   Aa^Fpa,   Aa^Fpa,   Aa^Fpa,   Aa^Fpa,   Aa^Fpa,       Ch,     3 Kh,       Ch,   Aa^Fpa,   Aa^Fpa,   Aa^Fpa,   Aa^Fpa,   Aa^Fpa,   Aa^Fpa,   Aa^Fpa,       Aa,       Aa,       Aa,   Aa^Fpa,       Aa,       Aa,       Aa,       Aa,       Aa,       Aa,       Aa,       Aa,       Aa,       Aa,       Aa,       Aa
   Aa^Fpa,   Aa^Fpa,   Aa^Fpa,   Aa^Fpa,   Aa^Fpa,   Aa^Fpa,   Aa^Fpa,       Ch,   Aa^Fpa,   Aa^Fpa,   Aa^Vea,   Aa^Fpa,   Aa^Fpa,   Aa^Fpa,       Aa,       Aa,       Aa,       Aa,       Aa,       Aa,       Aa,       Aa,       Aa,       Aa,       Aa,       Aa,       Aa,       Aa,       Aa,       Aa,       Aa,       Aa
   Aa^Fpa,   Aa^Fpa,   Aa^Fpa,   Aa^Fpa,   Aa^Fpa,   Aa^Fpa,   Aa^Fpa,   Aa^Fpa,   Aa^Fpa,   Aa^Fpa,   Aa^Fpa,   Aa^Fpa,       Aa,       Aa,       Aa,       Aa,       Aa,       Aa,       Aa,       Aa,       Aa,       Aa,       Aa,       Aa,       Aa,       Aa,       Aa,       Aa,       Aa,       Aa,       Aa,       Aa
   Aa^Fpa,   Aa^Fpa,   Aa^Fpa,   Aa^Fpa,   Aa^Fpa,   Aa^Fpa,   Aa^Fpa,   Aa^Fpa,   Aa^Fpa,   Aa^Fpa,   Aa^Fpa,   Aa^Fpa,       Aa,       Aa,       Aa,       Aa,       Aa,       Aa,       Aa,       Aa,       Aa,       Aa,       Aa,       Aa,       Aa,       Aa,       Aa,       Aa,       Aa,       Aa,       Aa,       Aa
