border_size=1
usage=map

       Gg,       Gg,       Gg,       Gg,       Gg,       Gg,       Gg,       Gg,       Gg,       Gg,       Gg,       Gg,       Gg,       Gg,       Gg,       Gg,       Gg,       Gg,       Gg,       Gg,       Gg,       Gg,       Gg,       Gg,       Gg,       Gg,       Gg,       Gg,       Gg,       Gg,       Gg,       Gg,       Gg,    Gg,       Gg,       Gg,       Gg,       Gg,       Ww,       Ww,       Ww
       Gg,       Gg,       Gg,       Gg,       Gg,       Gg,       Gg,       Gg,       Gg,       Gg,       Gg,       Gg,       Gg,       Gg,       Gg,       Gg,       Gg,       Gg,       Gg,       Gg,       Gg,       Gg,       Gg,       Gg,       Gg,       Gg,       Gg,       Gg,       Gg,       Gg,       Gg,       Gg,       Gg,    Gg^Vh,       Gg,       Gg,       Gg,       Gg,       Ww,       Ww,       Ww
       Gg,       Gg,       Gg,       Gg,       Gg,       Gg,       Gg,       Gg,       Gg,       Gg,       Gg,       Gg,       Gg,       Gg,       Gg,       Gg,       Gg,    Gg^Vh,       Gg,       Gg,       Gg,       Gg,       Gg,       Gg,       Gg,       Gg,       Gg,       Gg,       Gg,       Gg,       Gg,       Gg,       Gg,       Gg,       Ds,       Ds,       Gg,       Gg,       Gg,       Gg,       Gg
       Gg,       Gg,       Gg,       Gg,       Gg,       Gg,       Gg,       Gg,       Gg,       Gg,       Gg,       Gg,       Gg,       Gg,       Gg,       Gg,       Gg,       Gg,       Gg,       Gg,       Gg,       Gg,       Gg,       Gg,       Gg,       Gg,       Gg,       Gg,       Gg,       Gg,       Gg,       Gg,       Gg,       Gg,       Gg,       Gg,    Gg^Ve,       Gg,       Gg,       Gg,       Gg
       Gg,       Gg,       Gg,       Gg,       Gg,       Gg,       Gg,       Gg,       Gg,       Gg,       Gg,       Gg,       Gg,       Gg,       Gg,       Gg,       Gg,       Gg,       Gg,       Gg,       Gg,       Gg,       Gg,       Gg,       Gg,       Gg,       Gg,       Gg,       Gg,       Gg,       Gg,       Gg,       Gg,       Gg,       Gg,       Gg,       Gg,       Gg,       Gg,       Gg,       Gg
       Gg,       Gg,       Gg,       Gg,       Gg,       Gg,       Gg,       Gg,       Gg,       Gg,       Gg,       Gg,       Gg,       Gg,       Gg,       Gg,       Gg,    Gg^Ve,       Gg,       Gg,       Gg,       Gg,       Gg,       Gg,       Gg,       Ww,       Ww,       Gg,       Ww,       Ww,       Hh,       Hh,       Hh,       Hh,       Gg,       Gg,       Gg,       Gg,       Gg,       Gg,       Gg
       Gg,       Gg,       Gg,       Gg,       Gg,       Gg,       Gg,       Gg,       Gg,       Gg,       Gg,       Gg,       Gg,       Gg,       Gg,       Gg,       Gg,       Gg,       Gg,       Gg,       Gg,       Gg,       Gg,       Gg,       Gg,    Gg^Vh,       Gg,       Gg,    Gg^Vh,       Ww,       Ww,       Hh,       Hh,       Hh,       Gg,       Gg,    Gg^Ve,       Gg,       Gg,       Gg,       Gg
       Gg,       Gg,       Gg,       Gg,       Gg,       Gg,       Gg,       Gg,       Gg,       Gg,       Gg,       Gg,       Gg,       Gg,       Gg,       Gg,       Gg,       Gg,       Gg,       Gg,       Gg,       Gg,       Gg,       Gg,       Ww,       Gg,       Ch,     2 Kh,       Ch,       Gg,       Ww,       Gg,       Hh,       Gg,       Gg,       Gg,       Gg,       Gg,       Gg,       Gg,       Gg
       Gg,       Gg,       Gg,       Gg,       Gg,       Gg,       Gg,       Gg,       Gg,       Gg,       Gg,       Gg,       Gg,       Gg,       Gg,       Gg,       Gg,    Gg^Ve,       Gg,       Gg,       Gg,       Gg,       Gg,       Gg,       Gg,       Ww,     3 Kh,       Ch,       Ch,     4 Kh,       Gg,       Gg,       Gg,       Gg,    Gg^Vh,       Gg,       Gg,       Gg,    Gs^Fp,       Gg,       Gg
       Gg,       Gg,       Gg,       Gg,       Gg,       Gg,       Gg,       Gg,       Gg,       Gg,       Gg,       Gg,       Gg,       Gg,       Gg,       Gg,       Gg,       Gg,       Gg,       Gg,    Gg^Vh,       Gg,       Gg,       Gg,       Ww,       Ww,       Ch,       Ch,     1 Kh,       Ch,       Gg,       Gg,       Gg,       Gg,       Gg,       Gg,       Gg,    Gs^Fp,    Gs^Fp,       Gg,       Gg
       Gg,       Gg,       Gg,       Gg,       Gg,       Gg,       Gg,       Gg,       Gg,       Gg,       Gg,       Gg,       Gg,       Gg,       Gg,       Gg,       Gg,       Gg,       Gg,       Gg,       Gg,       Gg,       Gg,       Ww,       Gg,       Gg,       Ch,       Ch,       Ch,       Ww,       Ww,       Gg,       Gg,       Gg,       Gg,       Gg,       Gg,    Gs^Fp,    Gs^Fp,       Gg,       Gg
       Gg,       Gg,       Gg,       Gg,       Gg,       Gg,       Gg,       Gg,       Gg,       Gg,       Gg,       Gg,       Gg,       Gg,       Gg,       Gg,       Gg,       Gg,       Gg,       Gg,       Gg,       Gg,       Gg,       Ww,       Gg,    Gg^Vh,       Gg,       Gg,       Gg,       Ww,       Gg,       Gg,       Gg,       Gg,       Gg,       Gg,    Gs^Fp,    Gs^Fp,    Gs^Fp,       Gg,       Gg
       Gg,       Gg,       Gg,       Gg,       Gg,       Gg,       Gg,       Gg,       Gg,       Gg,       Gg,       Gg,       Gg,       Gg,       Gg,       Gg,       Gg,       Gg,       Gg,       Gg,       Gg,       Gg,       Gg,       Gg,       Gg,       Gg,       Gg,       Gg,       Gg,       Gg,       Gg,       Gg,       Gg,       Gg,       Gg,       Gg,       Gg,       Gg,       Gg,       Gg,       Gg
       Gg,       Gg,       Gg,       Gg,       Gg,       Gg,       Gg,       Gg,       Gg,       Gg,       Gg,       Gg,       Gg,       Gg,       Gg,       Gg,       Gg,       Gg,       Gg,       Gg,       Gg,       Gg,    Gg^Vh,       Gg,       Gg,       Gg,       Gg,       Gg,    Gg^Vh,       Ww,       Gg,       Gg,       Gg,       Gg,       Gg,       Gg,       Gg,       Gg,       Gg,       Gg,       Gg
       Gg,       Gg,       Gg,       Gg,       Gg,       Gg,       Gg,       Gg,       Gg,       Gg,       Gg,       Gg,       Gg,       Gg,       Gg,       Gg,       Gg,       Gg,       Gg,       Gg,       Gg,       Gg,    Gg,       Gg,       Gg,       Gg,       Gg,       Gg,    Gg,       Ww,       Gg,       Gg,       Gg,       Gg,       Gg,       Gg,       Gg,       Gg,       Gg,       Gg,       Gg
