border_size=1
usage=map

       Mm,       Mm,       Mm,       Mm,       Mm,       Mm,       Mm,       Hh,       Hh,       Hh,       Hh,       Hh,    Gg,       Mm,       Mm,       Mm,    Gs^Fp,    Gs^Fp,    Gs^Fp,    Gs^Fp,    Gs^Fp,    Gs^Fp,    Gs^Fp,    Gs^Fp,    Gs^Fp,    Gs^Fp,    Gs^Fp,    Gs^Fp,    Gs^Fp,    Gs^Fp,    Gs^Fp,    Gs^Fp,    Gs^Fp,    Gs^Fp,    Gs^Fp,    Gs^Fp,    Gs^Fp,    Gs^Fp,    Gs^Fp,    Gs^Fp,    Gs^Fp,    Gs^Fp,    Gs^Fp,    Gs^Fp,    Gs^Fp,    Gs^Fp,    Gs^Fp,    Gs^Fp,       Mm,       Mm,       Mm,       Mm,       Mm,    Gg,       Mm,       Mm,       Mm,       Mm,       Mm,       Mm,       Mm,       Mm,       Mm,       Mm
       Mm,       Mm,       Mm,       Mm,       Mm,       Mm,       Mm,       Hh,       Hh,       Hh,       Hh,       Hh,    Gg^Ve,       Mm,       Mm,       Mm,    Gs^Fp,    Gs^Fp,    Gs^Fp,    Gs^Fp,    Gs^Fp,    Gs^Fp,    Gs^Fp,    Gs^Fp,    Gs^Fp,    Gs^Fp,    Gs^Fp,    Gs^Fp,    Gs^Fp,    Gs^Fp,    Gs^Fp,    Gs^Fp,    Gs^Fp,    Gs^Fp,    Gs^Fp,    Gs^Fp,    Gs^Fp,    Gs^Fp,    Gs^Fp,    Gs^Fp,    Gs^Fp,    Gs^Fp,    Gs^Fp,    Gs^Fp,    Gs^Fp,    Gs^Fp,    Gs^Fp,    Gs^Fp,       Mm,       Mm,       Mm,       Mm,       Mm,    Gg^Ve,       Mm,       Mm,       Mm,       Mm,       Mm,       Mm,       Mm,       Mm,       Mm,       Mm
       Mm,       Mm,       Mm,       Mm,       Mm,       Mm,       Mm,       Hh,       Hh,       Hh,       Hh,       Hh,       Hh,       Hh,       Mm,       Mm,    Gs^Fp,    Gs^Fp,    Gs^Fp,    Gs^Fp,    Gs^Fp,    Gs^Fp,    Gg^Ve,    Gs^Fp,    Gs^Fp,    Gs^Fp,    Gs^Fp,    Gs^Fp,    Gs^Fp,    Gs^Fp,    Gs^Fp,    Gs^Fp,    Gs^Fp,    Gs^Fp,    Gs^Fp,    Gs^Fp,    Gs^Fp,    Gs^Fp,    Gs^Fp,    Gs^Fp,    Gs^Fp,       Hh,       Hh,    Gs^Fp,    Gs^Fp,    Gs^Fp,    Gs^Fp,    Gs^Fp,    Gs^Fp,    Gs^Fp,       Mm,       Mm,       Mm,       Mm,       Mm,       Mm,       Mm,       Mm,       Mm,       Mm,    Gg^Ve,       Mm,       Mm,       Mm
       Mm,       Mm,       Mm,       Mm,       Mm,       Mm,       Hh,       Hh,       Hh,       Hh,       Hh,       Hh,       Hh,       Hh,       Mm,    Gs^Fp,    Gs^Fp,    Gs^Fp,    Gs^Fp,    Gs^Fp,    Gs^Fp,       Ww,       Ww,       Ww,       Ww,       Ww,       Ww,       Ww,       Ww,       Ww,       Ww,       Mm,       Mm,       Hh,       Hh,       Hh,       Ch,     3 Kh,       Ch,    Gs^Fp,       Hh,       Hh,       Hh,       Hh,       Hh,       Hh,       Hh,       Hh,       Hh,       Hh,       Hh,       Mm,       Mm,       Mm,       Mm,       Mm,       Mm,       Mm,       Mm,       Mm,       Mm,       Mm,       Mm,       Mm
       Mm,       Mm,       Mm,       Mm,       Mm,       Mm,       Mm,       Mm,       Mm,       Mm,       Mm,       Mm,       Hh,       Hh,       Hh,       Hh,       Hh,       Hh,       Hh,       Hh,       Hh,    Gs^Fp,       Hh,       Ww,       Ww,       Ww,       Ww,       Ww,       Ww,       Ww,       Ww,       Ww,       Ww,       Ww,       Ww,       Ww,     4 Kh,     1 Kh,     5 Kh,       Mm,       Mm,       Mm,       Mm,       Mm,       Mm,       Mm,       Mm,       Mm,       Mm,       Mm,       Mm,       Mm,       Mm,       Mm,       Mm,       Mm,       Mm,       Mm,       Mm,       Mm,       Mm,       Mm,       Mm,       Mm
       Mm,       Mm,       Mm,       Mm,       Mm,       Mm,       Mm,       Mm,       Mm,       Mm,       Mm,       Hh,       Hh,       Hh,       Hh,       Hh,       Hh,       Hh,       Hh,    Gs^Fp,    Gs^Fp,    Gs^Fp,       Ww,       Ww,       Ww,       Ww,       Ww,       Ww,       Ww,       Ww,       Ww,       Ww,       Ww,       Ww,       Ww,       Ww,       Ch,     2 Kh,       Ch,       Hh,       Hh,       Hh,       Hh,       Hh,    Gg^Ve,       Mm,       Mm,       Mm,       Mm,       Mm,       Mm,       Mm,       Mm,       Mm,       Mm,       Mm,       Mm,       Mm,       Mm,       Mm,       Mm,       Mm,       Mm,       Mm
       Mm,       Mm,       Mm,       Mm,       Mm,       Mm,       Mm,       Mm,       Mm,       Mm,       Mm,       Hh,       Hh,       Hh,       Hh,       Hh,       Hh,       Hh,       Hh,       Hh,    Gs^Fp,    Gs^Fp,    Gs^Fp,    Gs^Fp,       Ww,       Ww,       Ww,       Ww,       Ww,       Ww,       Ww,       Ww,       Ww,       Ww,       Ww,       Ww,    Gs^Fp,       Hh,       Re,       Hh,       Hh,       Hh,       Hh,    Gs^Fp,    Gs^Fp,    Gs^Fp,    Gs^Fp,    Gs^Fp,    Gs^Fp,    Gs^Fp,    Gs^Fp,    Gs^Fp,       Mm,       Mm,       Mm,       Mm,       Mm,       Mm,       Mm,       Mm,       Mm,       Mm,       Mm,       Mm
       Mm,       Mm,       Mm,       Mm,       Mm,    Gg^Ve,       Mm,       Mm,       Mm,       Mm,       Hh,       Hh,       Hh,       Hh,       Hh,       Hh,       Hh,       Hh,    Gs^Fp,    Gs^Fp,    Gs^Fp,    Gs^Fp,    Gs^Fp,    Gs^Fp,    Gs^Fp,    Gs^Fp,    Gs^Fp,       Ww,       Ww,       Ww,       Ww,       Ww,       Ww,       Ww,       Ww,       Ww,    Gs^Fp,    Gs^Fp,       Re,       Re,       Hh,       Hh,       Hh,       Hh,       Hh,       Hh,       Hh,       Hh,    Gs^Fp,    Gs^Fp,    Gs^Fp,    Gs^Fp,    Gs^Fp,    Gs^Fp,    Gs^Fp,    Gs^Fp,       Mm,       Mm,       Mm,       Mm,       Mm,       Mm,       Mm,       Mm
       Mm,       Mm,       Mm,       Mm,       Mm,       Mm,       Mm,       Mm,       Mm,       Mm,       Hh,       Hh,       Hh,       Hh,       Hh,    Gs^Fp,    Gs^Fp,    Gs^Fp,    Gs^Fp,    Gs^Fp,    Gs^Fp,    Gs^Fp,    Gs^Fp,    Gs^Fp,    Gs^Fp,    Gs^Fp,    Gs^Fp,       Re,       Re,    Gs^Fp,       Ww,       Ww,       Ww,       Ww,       Ww,       Ww,    Gs^Fp,    Gs^Fp,       Re,       Re,    Gs^Fp,    Gs^Fp,    Gs^Fp,       Hh,       Hh,       Hh,       Hh,       Hh,       Hh,       Hh,       Hh,    Gs^Fp,    Gs^Fp,    Gs^Fp,    Gs^Fp,    Gs^Fp,    Gs^Fp,       Mm,       Mm,       Mm,       Mm,       Mm,       Mm,       Mm
       Mm,       Mm,       Mm,       Mm,       Mm,       Mm,       Mm,       Mm,       Mm,       Mm,       Hh,       Hh,       Hh,       Hh,       Hh,    Gs^Fp,    Gs^Fp,    Gs^Fp,    Gs^Fp,    Gs^Fp,    Gs^Fp,    Gs^Fp,    Gs^Fp,    Gs^Fp,    Gs^Fp,    Gs^Fp,    Gs^Fp,       Re,       Re,    Gs^Fp,       Ww,       Ww,       Ww,       Ww,       Ww,       Ww,    Gs^Fp,    Gs^Fp,       Re,       Re,    Gs^Fp,    Gs^Fp,    Gs^Fp,       Hh,       Hh,       Hh,       Hh,       Hh,       Hh,       Hh,       Hh,    Gs^Fp,    Gs^Fp,    Gs^Fp,    Gs^Fp,    Gs^Fp,    Gs^Fp,       Mm,       Mm,       Mm,       Mm,       Mm,       Mm,       Mm
